111111111111111111111
111111X11X10001C11111
1P00000000101010000E1
111111C11000100011111
111111111111111111111
