111111111111111
1001C00100001E1
1000010101001P1
101010010110101
1X00000101C0101
10X0X0000100001
111111111111111
