111111111111111
1C01000100010C1
100X01010100001
110X01010100011
100001000100001
101111010111101
1000C10101C0001
101111010111101
100000P1E000001
111111111111111
