11111111111111111111111111111111111
10010010010010010P01001001001001001
10010010010010010001001001001001001
10010010010C00000000000C01001001001
10010010010010010001001001001001001
10010010010010010E01001001001001001
11111111111111111111111111111111111
