111111111111111
1001C00100001E1
1000010101001P1
101010010110101
1000000101C0101
100000000100001
111111111111111
