1111
1PE1
1CC1
1001
0001
1001
1101
