1111
1EC1
1P10
1010
1001
1001
1001
