111111111
100S00C01
111111111
