1111
1CP1
1C01
10C111111
1CC0000E1
111111111
